[subject]	object	i
od:Schadeveroorzakende_gebeurtenis	Doen and Nalaten	[Doen, Nalaten]
od:Aard_van_de_vergunning	Hinderhandeling and Inbreukhandeling	[Hinderhandeling, Inbreukhandeling]
od:Roerende_zaken	Nalaten and Werkhandeling	[Nalaten, Werkhandeling]
od:Aard_van_de_gedraging	Doen and Nalaten	[Doen, Nalaten]
od:Aard_van_de_gepublliceerde_verdenking	Inbreukhandeling and Werkhandeling	[Inbreukhandeling, Werkhandeling]
od:Ernst_van_de_gevolgen	Doen and Nalaten	[Doen, Nalaten]
od:Aansprakelijkheid_voor_stortplaatsen	heeft_handeling some Werkhandeling	
od:Doel_van_de_contractspartijen	Nalaten and Wanprestatie and Werkhandeling	[Nalaten, Wanprestatie, Werkhandeling]
od:Leveringsvoowaarden	Wanprestatie and Werkhandeling	[Wanprestatie, Werkhandeling]
od:Onbeheersbare_ondergrondse_natuurlijke_krachten	Nalaten and Werkhandeling	[Nalaten, Werkhandeling]
od:Aansprakelijkheid_voor_ondergeschikten	heeft_handeling some Werkhandeling	
od:Aanduiding_of_het_doel_van_de_aanbieding	Inbreukhandeling and Nalaten and Werkhandeling and Zorgplicht	[Inbreukhandeling, Nalaten, Werkhandeling, Zorgplicht]
od:Gezag_van_de_bron	Inbreukhandeling and Werkhandeling	[Inbreukhandeling, Werkhandeling]
od:Afwezigheid_van_zeggenschap	Nalaten and Werkhandeling	[Nalaten, Werkhandeling]
od:Hulpbetoon	Doen and Nalaten	[Doen, Nalaten]
od:Aard_van_de_aansprakelijkheid	Doen and Nalaten	[Doen, Nalaten]
od:Voorzienbaarheid_van_de_schade	Doen and Nalaten	[Doen, Nalaten]
od:Inkleding_van_de_verdenkingen	Inbreukhandeling and Werkhandeling	[Inbreukhandeling, Werkhandeling]
od:Persoon_van_de_gelaedeerde	Doen and Nalaten	[Doen, Nalaten]
od:Delfstoffen	Nalaten and Werkhandeling	[Nalaten, Werkhandeling]
od:Mate_van_waarschijnlijkheid_schade	Doen and Nalaten	[Doen, Nalaten]
od:Onduidelijkheid_van_de_verstrekte_gegevens	Nalaten and Werkhandeling	[Nalaten, Werkhandeling]
od:Art_6_175_lid_6	Nalaten and Werkhandeling	[Nalaten, Werkhandeling]
od:Eigen_energie_van_het_dier	Gevaarshandeling and Hinderhandeling and Nalaten	[Gevaarshandeling, Hinderhandeling, Nalaten]
od:Handelen_in_strijd_met_een_wettelijke_plicht	Doen and Nalaten	[Doen, Nalaten]
Inbreukhandeling	od:Intensiteit_van_de_inbreuk	
od:Roerende_zaak	Beslag_gelegd and Nalaten	[Beslag_gelegd, Nalaten]
od:Bodembeweging	Nalaten and Werkhandeling	[Nalaten, Werkhandeling]
od:Ernst_en_duur	Doen and Nalaten	[Doen, Nalaten]
od:Aard_van_de_aanwijzing	Nalaten and Verkeershandeling and Werkhandeling	[Nalaten, Verkeershandeling, Werkhandeling]
od:Overtreding_gebruiksvoorschriften_bij_de_sluiting	Inbreukhandeling and Nalaten	[Inbreukhandeling, Nalaten]
od:Aansprakelijkheid_voor_vertegenwoordigers	(heeft_handeling some Inbreukhandeling) or (heeft_handeling some Wanprestatie) or (heeft_handeling some Werkhandeling)	
od:Houder_van_een_dier	Gevaarshandeling and Hinderhandeling and Nalaten	[Gevaarshandeling, Hinderhandeling, Nalaten]
od:Onbehoorlijk_aanhaken_producten_of_diensten	Inbreukhandeling and Werkhandeling	[Inbreukhandeling, Werkhandeling]
od:Onroerende_zaken	Beslag_gelegd and Werkhandeling	[Beslag_gelegd, Werkhandeling]
od:Aantasting_kwaliteit_van_leven	Hinderhandeling and Inbreukhandeling and Nalaten	[Hinderhandeling, Inbreukhandeling, Nalaten]
od:Dier	Gevaarshandeling and Hinderhandeling and Nalaten	[Gevaarshandeling, Hinderhandeling, Nalaten]
Werkhandeling	od:Gezagsverhouding	
od:Beschikbare_alternatieven	Nalaten and Werkhandeling	[Nalaten, Werkhandeling]
od:Persoon_van_de_laedens	Doen and Nalaten	[Doen, Nalaten]
od:Omstandigheden_van_het_geval	Doen and Nalaten	[Doen, Nalaten]
Werkhandeling	od:Beschermingsbehoefte	
od:Prijs_van_het_product	Inbreukhandeling and Werkhandeling	[Inbreukhandeling, Werkhandeling]
od:Wijze_of_tijdstip_van_vervaardigen_van_het_product	Inbreukhandeling and Werkhandeling	[Inbreukhandeling, Werkhandeling]
od:Eigenaar_van_een_dier	Gevaarshandeling and Hinderhandeling and Nalaten	[Gevaarshandeling, Hinderhandeling, Nalaten]
Werkhandeling	od:Redelijk_bekwaam_vakgenoot	
od:Steun_van_verdenking_in_feitenmateriaal	Inbreukhandeling and Werkhandeling	[Inbreukhandeling, Werkhandeling]
od:Illegaal_storten	Nalaten and Werkhandeling	[Nalaten, Werkhandeling]
od:Beperking_van_het_nadeel_door_perspubilcatie	Inbreukhandeling and Nalaten and Werkhandeling and Zorgplicht	[Inbreukhandeling, Nalaten, Werkhandeling, Zorgplicht]
od:Eigenschappen_van_het_product	Nalaten and Werkhandeling	[Nalaten, Werkhandeling]
od:Aansprakelijkheid_voor_boorgaten	(heeft_handeling some Gevaarshandeling) or (heeft_handeling some Werkhandeling)	
Inbreukhandeling	od:Aard_en_de_werkwijze_van_de_media	
od:Plaats_van_de_daad	Doen and Nalaten	[Doen, Nalaten]
od:Misleidende_en_vergelijkende_reclame	(heeft_handeling some Algemene_handeling) or (heeft_handeling some Inbreukhandeling) or (heeft_handeling some Nalaten)	
od:Onevenredig_getroffen	Inbreukhandeling and Nalaten and Werkhandeling	[Inbreukhandeling, Nalaten, Werkhandeling]
od:Afwijking_in_de_gronddekking	Nalaten and Werkhandeling	[Nalaten, Werkhandeling]
od:Veiligheidsvoorschriften	Gevaarshandeling and Nalaten	[Gevaarshandeling, Nalaten]
od:Voorzorgsmaatregelen	Doen and Nalaten	[Doen, Nalaten]
od:Aansprakelijkheid_voor_personen	heeft_handeling some Verkeershandeling	
od:Schepen	Algemene_handeling and Beslag_gelegd	[Algemene_handeling, Beslag_gelegd]
Algemene_handeling	od:Eigendomsvoorbehoud	
od:Aard_van_de_fout	Nalaten and Verkeershandeling and Werkhandeling	[Nalaten, Verkeershandeling, Werkhandeling]
od:Bestaan_van_andere_gegevens	Inbreukhandeling and Nalaten and Werkhandeling	[Inbreukhandeling, Nalaten, Werkhandeling]
od:Fabrikant_van_een_onderdeel	Nalaten and Werkhandeling	[Nalaten, Werkhandeling]
od:Hoedanigheid_van_de_gegevensverstrekker	Nalaten and Werkhandeling	[Nalaten, Werkhandeling]
od:Art_6_175_lid_1	Nalaten and Werkhandeling	[Nalaten, Werkhandeling]
Werkhandeling	od:Zeggenschap	
od:Handelen_in_strijd_met_hetgeen_in_het_maatschappelijk_verkeer_betaamt	Doen and Nalaten	[Doen, Nalaten]
od:Product_dat_niet_de_veiligheid_biedt	Nalaten and Werkhandeling	[Nalaten, Werkhandeling]
od:Kwalitatieve_aansprakelijkheid	heeft_handeling some Algemene_handeling	
Werkhandeling	od:Krachtens_volmacht	
od:Bezwaarlijkheid_veiligheidsmaatregelen	Gevaarshandeling and Hinderhandeling and Nalaten	[Gevaarshandeling, Hinderhandeling, Nalaten]
Werkhandeling	od:Hulppersonen	
od:Persoonlijke_aansprakelijkheid	heeft_handeling some Handeling	
od:Aansprakelijkheid_voor_zaken	(heeft_handeling some Gevaarshandeling) or (heeft_handeling some Nalaten)	
Werkhandeling	od:Afwijking_van_de_normaalbladen	
Werkhandeling	od:Kansvergroting	
od:Redelijkerwijs_te_verwachten_gebruik	Nalaten and Werkhandeling	[Nalaten, Werkhandeling]
od:Aansprakelijkheid_voor_gebrekkige_zaken	(heeft_handeling some Gevaarshandeling) or (heeft_handeling some Hinderhandeling) or (heeft_handeling some Werkhandeling)	
od:Kenbaarheid	Doen and Nalaten	[Doen, Nalaten]
Werkhandeling	od:Tijdstip_van_de_fout	
od:Verklaringen_over_en_weer	Nalaten and Wanprestatie and Werkhandeling and Zorgplicht	[Nalaten, Wanprestatie, Werkhandeling, Zorgplicht]
od:Blootstelling_aan_verdachtmaking	Inbreukhandeling and Nalaten and Werkhandeling	[Inbreukhandeling, Nalaten, Werkhandeling]
Werkhandeling	od:Praktische_indicatoren	
od:Aansprakelijkheid_voor_gevaarlijke_stoffen	(heeft_handeling some Gevaarshandeling) or (heeft_handeling some Werkhandeling)	
od:Gebruiksmogelijkheden	Nalaten and Werkhandeling	[Nalaten, Werkhandeling]
od:Toestemming_van_de_benadeelde	Doen and Nalaten	[Doen, Nalaten]
od:Krachtens_amvb	Doen and Nalaten	[Doen, Nalaten]
od:Vergunninghouder	Hinderhandeling and Inbreukhandeling and Nalaten	[Hinderhandeling, Inbreukhandeling, Nalaten]
od:Veroudering_van_gegevens	Nalaten and Werkhandeling	[Nalaten, Werkhandeling]
od:Medebezitter	Gevaarshandeling and Nalaten	[Gevaarshandeling, Nalaten]
od:Legaal_storten	Inbreukhandeling and Nalaten and Werkhandeling	[Inbreukhandeling, Nalaten, Werkhandeling]
od:Aanbieder	Gevaarshandeling and Inbreukhandeling and Nalaten and Werkhandeling and Zorgplicht	[Gevaarshandeling, Inbreukhandeling, Nalaten, Werkhandeling, Zorgplicht]
od:Presentatie_van_het_product	Inbreukhandeling and Nalaten and Werkhandeling	[Inbreukhandeling, Nalaten, Werkhandeling]
Werkhandeling	od:Betalingsvoorwaarden	
Werkhandeling	od:Opgedragen_taak	
Werkhandeling	od:Werkzaamheden_met_een_incidenteel_karakter	
od:Krachtens_wet	Doen and Nalaten	[Doen, Nalaten]
od:Zoeken_van_de_publiciteit	Inbreukhandeling and Werkhandeling	[Inbreukhandeling, Werkhandeling]
od:Verklaring_of_beoordeling	Inbreukhandeling and Werkhandeling	[Inbreukhandeling, Werkhandeling]
od:Fabrikant_van_een_eindproduct	Nalaten and Werkhandeling	[Nalaten, Werkhandeling]
od:Kans_dat_anderen_niet_goed_opletten	Gevaarshandeling and Nalaten and Verkeershandeling	[Gevaarshandeling, Nalaten, Verkeershandeling]
od:Ieder_die_zich_als_producent_presenteert	Inbreukhandeling and Werkhandeling	[Inbreukhandeling, Werkhandeling]
od:Tijdstip_waarop_het_product_in_het_verkeer_is_gebracht	Nalaten and Werkhandeling	[Nalaten, Werkhandeling]
od:Productenaansprakelijkheid	(heeft_handeling some Gevaarshandeling) or (heeft_handeling some Inbreukhandeling) or (heeft_handeling some Nalaten) or (heeft_handeling some Wanprestatie)	
od:Hulpmiddel	Inbreukhandeling and Nalaten and Werkhandeling	[Inbreukhandeling, Nalaten, Werkhandeling]
Algemene_handeling	od:Goed_houden_voor_een_ander	
od:Aard_van_de_schade	Doen and Nalaten	[Doen, Nalaten]
od:Verzekerbaarheid_van_de_schade	Doen and Nalaten	[Doen, Nalaten]
od:Uitvoerbaareid_overeenkomst	Nalaten and Wanprestatie	[Nalaten, Wanprestatie]
od:Gevaarlijke_toestand	Gevaarshandeling and Nalaten	[Gevaarshandeling, Nalaten]
Algemene_handeling	od:Luchtvaartuigen	
Inbreukhandeling	od:Recht_op_vrijheid_van_meningsuiting	
od:Opdracht	Werkhandeling and Zorgplicht	[Werkhandeling, Zorgplicht]
od:Tolerantiegrenzen	Nalaten and Werkhandeling	[Nalaten, Werkhandeling]
od:Beoordeling_rangorde_grondrechten	Hinderhandeling and Inbreukhandeling	[Hinderhandeling, Inbreukhandeling]
od:Stoffelijke_objecten	Algemene_handeling and Beslag_gelegd	[Algemene_handeling, Beslag_gelegd]
od:Omvang_van_de_voorraad	Nalaten and Werkhandeling	[Nalaten, Werkhandeling]
od:Stand_van_techniek_en_ontwikkelingsrisico	Nalaten and Werkhandeling	[Nalaten, Werkhandeling]
od:Onmiddelijk_gevaar	Gevaarshandeling and Nalaten and Verkeershandeling	[Gevaarshandeling, Nalaten, Verkeershandeling]
od:Onjuistheid_van_de_gegevens	Nalaten and Werkhandeling	[Nalaten, Werkhandeling]
od:Dier_als_instrument	Gevaarshandeling and Hinderhandeling and Nalaten	[Gevaarshandeling, Hinderhandeling, Nalaten]
od:Doel_te_bereiken_via_andere_weg	Inbreukhandeling and Nalaten and Werkhandeling	[Inbreukhandeling, Nalaten, Werkhandeling]
od:Garantie	Nalaten and Werkhandeling	[Nalaten, Werkhandeling]
od:Aansprakelijkheid_voor_niet-ondergeschikten	heeft_handeling some Werkhandeling	
Algemene_handeling	od:Goed_houden_voor_zichzelf	
od:Verkeersopvatting	Doen and Nalaten	[Doen, Nalaten]
od:Aanwijzingsbevoegdheid	Inbreukhandeling and Nalaten and Werkhandeling	[Inbreukhandeling, Nalaten, Werkhandeling]
od:Aansprakelijkheid_voor_kinderen	(heeft_handeling some Gevaarshandeling) or (heeft_handeling some Hinderhandeling) or (heeft_handeling some Inbreukhandeling)	
od:Exploitant_stortplaats_zonder_vergunning	Nalaten and Werkhandeling	[Nalaten, Werkhandeling]
od:Voortbestaan_niet_bekende_misstanden	Inbreukhandeling and Nalaten and Werkhandeling	[Inbreukhandeling, Nalaten, Werkhandeling]
od:Bekendwording_20_jaar_na_sluiting	Nalaten and Werkhandeling	[Nalaten, Werkhandeling]
od:Kans_dat_daardoor_ongevallen_ontstaan	Gevaarshandeling and Nalaten and Verkeershandeling	[Gevaarshandeling, Nalaten, Verkeershandeling]
od:Maatschappelijke_betamelijkheid	Doen and Nalaten	[Doen, Nalaten]
Werkhandeling	od:Producent_van_een_grondstof	
od:Onnodig_grievend	Inbreukhandeling and Werkhandeling	[Inbreukhandeling, Werkhandeling]
od:Onrechtmatige_daad	(od:heeft_vereiste some od:Causaliteit_vestigingsfase) and (od:heeft_vereiste some od:Onrechtmatigheid) and (od:heeft_vereiste some od:Pleger_onrechtmatige_daad) and (od:heeft_vereiste some od:Relativiteit) and (od:heeft_vereiste some od:Schade) and (od:heeft_vereiste some od:Toerekening_vestigingsfase)	[od:heeft_vereiste some od:Causaliteit_vestigingsfase, od:heeft_vereiste some od:Onrechtmatigheid, od:heeft_vereiste some od:Pleger_onrechtmatige_daad, od:heeft_vereiste some od:Relativiteit, od:heeft_vereiste some od:Schade, od:heeft_vereiste some od:Toerekening_vestigingsfase]
od:Relativiteit	not od:Correctie_langemeijer and (od:heeft_vereiste some od:Norm_ter_bescherming_schade)	[not od:Correctie_langemeijer, od:heeft_vereiste some od:Norm_ter_bescherming_schade]
od:Groep	(od:heeft_deelnemer some od:Groepsdeelnemer) and (od:heeft_deelnemer min 2)	[od:heeft_deelnemer some od:Groepsdeelnemer, od:heeft_deelnemer min 2]
od:Doen_in_strijd_met_recht	(od:voldoet_aan some od:Handelen_in_strijd_met_een_wettelijke_plicht) or (od:voldoet_aan some od:Handelen_in_strijd_met_hetgeen_in_het_maatschappelijk_verkeer_betaamt) or (od:voldoet_aan some od:Inbreuk_op_een_recht)	
od:Toerekening_krachtens_wet	((od:Persoon and (od:heeft_toestand some od:Lichamelijke_tekortkoming)) or (od:heeft_toestand some od:Geestelijke_tekortkoming)) and not od:Kind_jonger_dan_14_jaar	[(od:Persoon and (od:heeft_toestand some od:Lichamelijke_tekortkoming)) or (od:heeft_toestand some od:Geestelijke_tekortkoming), not od:Kind_jonger_dan_14_jaar]
od:Relativiteit	not od:Norm_ter_bescherming_schade and (od:heeft_vereiste some od:Correctie_langemeijer)	[not od:Norm_ter_bescherming_schade, od:heeft_vereiste some od:Correctie_langemeijer]
od:Nalaten_in_strijd_met_recht	(od:voldoet_aan some od:Handelen_in_strijd_met_een_wettelijke_plicht) or (od:voldoet_aan some od:Handelen_in_strijd_met_hetgeen_in_het_maatschappelijk_verkeer_betaamt)	
od:Inbreukcriterium	(((od:heeft_vereiste some od:Onbevoegd_uitoefenen_bevoegdheden) or (od:heeft_vereiste some od:Verhindering_in_de_uitoefening_van_bevoegdheden)) and not (od:heeft_vereiste some od:Onbevoegd_uitoefenen_bevoegdheden) and (od:heeft_vereiste some od:Verhindering_in_de_uitoefening_van_bevoegdheden)) and (od:heeft_vereiste some od:Subjectief_recht)	[((od:heeft_vereiste some od:Onbevoegd_uitoefenen_bevoegdheden) or (od:heeft_vereiste some od:Verhindering_in_de_uitoefening_van_bevoegdheden)) and not (od:heeft_vereiste some od:Onbevoegd_uitoefenen_bevoegdheden) and (od:heeft_vereiste some od:Verhindering_in_de_uitoefening_van_bevoegdheden), od:heeft_vereiste some od:Subjectief_recht]
od:Toerekening_vestigingsfase	(not od:betreft_persoon some od:Kind_jonger_dan_14_jaar and (od:betreft_persoon some od:Kind_16_jaar_en_ouder) and (od:betreft_persoon some od:Kind_tussen_de_14_en_16_jaar) and (od:betreft_persoon some od:Volwassene)) and (od:heeft_vereiste some od:Onrechtmatigheid)	[not od:betreft_persoon some od:Kind_jonger_dan_14_jaar and (od:betreft_persoon some od:Kind_16_jaar_en_ouder) and (od:betreft_persoon some od:Kind_tussen_de_14_en_16_jaar) and (od:betreft_persoon some od:Volwassene), od:heeft_vereiste some od:Onrechtmatigheid]
od:Aansprakeljkheid	(od:heeft_relatie_met some od:Wetsbepaling) and (od:heeft_vereiste some od:Toerekening_omvangsfase)	[od:heeft_relatie_met some od:Wetsbepaling, od:heeft_vereiste some od:Toerekening_omvangsfase]
